200
30
0 0 0 0 0 0 0  0 0 0 0  0 0 0 0 0 0  0 0  0 0  0 0  0 0  0 0 0 0  0 0  0 0 0 0  0 0 0 0  0 0 0 0 0 0  0 0 0 0  0 0  0 0 0  0 0  0 0 0  0 0  0 0 0  0 0  0 0 0 0  0 0 0 0  0 0 0 0 0 0 0 0 0 0 0 0 0 0 0 0 0 0 0 0 0 0 0 0 0 0 0 0 0 0 0 0 0 0 0 0 0 0 0 0 0 0 0 0 0 0 0 0 0 0 0 0 0 0 0 0 0 0 0 0 0 0 0 0 0 0 0 0 0 0 0 0 0 0 0 0 0 0 0 0 0 0 0 0 0 0 0 0 0 0 0 0 0 0 0 0 0 0 0 0 0 0 0 0 0 0 0 0 0 0 0 0 0 0 0 0 0 0 0 0 0 0 0 0 0 0
0 0 0 0 0 0 0  0 0 0 0  0 0 0 0 0 0  0 0  0 0  0 0  0 0  0 0 0 0  0 0  0 0 0 0  0 0 0 0  0 0 0 0 0 0  0 0 0 0  0 0  0 0 0  0 0  0 0 0  0 0  0 0 0  0 0  0 0 0 0  0 0 0 0  0 0 0 0 0 0 0 0 0 0 0 0 0 0 0 0 0 0 0 0 0 0 0 0 0 0 0 0 0 0 0 0 0 0 0 0 0 0 0 0 0 0 0 0 0 0 0 0 0 0 0 0 0 0 0 0 0 0 0 0 0 0 0 0 0 0 0 0 0 0 0 0 0 0 0 0 0 0 0 0 0 0 0 0 0 0 0 0 0 0 0 0 0 0 0 0 0 0 0 0 0 0 0 0 0 0 0 0 0 0 0 0 0 0 0 0 0 0 0 0 0 0 0 0 0 0
0 0 0 0 0 0 0  0 0 0 0  0 0 0 0 0 0  0 0  0 0  0 0  0 0  0 0 0 0  0 0  0 0 0 0  0 0 0 0  0 0 0 0 0 0  0 0 0 0  0 0  0 0 0  0 0  0 0 0  0 0  0 0 0  0 0  0 0 0 0  0 0 0 0  0 0 0 0 0 0 0 0 0 0 0 0 0 0 0 0 0 0 0 0 0 0 0 0 0 0 0 0 0 0 0 0 0 0 0 0 0 0 0 0 0 0 0 0 0 0 0 0 0 0 0 0 0 0 0 0 0 0 0 0 0 0 0 0 0 0 0 0 0 0 0 0 0 0 0 0 0 0 0 0 0 0 0 0 0 0 0 0 0 0 0 0 0 0 0 0 0 0 0 0 0 0 0 0 0 0 0 0 0 0 0 0 0 0 0 0 0 0 0 0 0 0 0 0 0 0
0 0 0 0 0 0 0  0 0 0 0  0 0 0 0 0 0  0 0  0 0  0 0  0 0  0 0 0 0  0 0  0 0 0 0  0 0 0 0  0 0 0 0 0 0  0 0 0 0  0 0  0 0 0  0 0  0 0 0  0 0  0 0 0  0 0  0 0 0 0  0 0 0 0  0 0 0 0 0 0 0 0 0 0 0 0 0 0 0 0 0 0 0 0 0 0 0 0 0 0 0 0 0 0 0 0 0 0 0 0 0 0 0 0 0 0 0 0 0 0 0 0 0 0 0 0 0 0 0 0 0 0 0 0 0 0 0 0 0 0 0 0 0 0 0 0 0 0 0 0 0 0 0 0 0 0 0 0 0 0 0 0 0 0 0 0 0 0 0 0 0 0 0 0 0 0 0 0 0 0 0 0 0 0 0 0 0 0 0 0 0 0 0 0 0 0 0 0 0 0
0 0 0 0 0 0 0  0 0 0 0  0 0 0 0 0 0  0 0  0 0  0 0  0 0  0 0 0 0  0 0  0 0 0 0  0 0 0 0  0 0 0 0 0 0  0 0 0 0  0 0  0 0 0  0 0  0 0 0  0 0  0 0 0  0 0  0 0 0 0  0 0 0 0  0 0 0 0 0 0 0 0 0 0 0 0 0 0 0 0 0 0 0 0 0 0 0 0 0 0 0 0 0 0 0 0 0 0 0 0 0 0 0 0 0 0 0 0 0 0 0 0 0 0 0 0 0 0 0 0 0 0 0 0 0 0 0 0 0 0 0 0 0 0 0 0 0 0 0 0 0 0 0 0 0 0 0 0 0 0 0 0 0 0 0 0 0 0 0 0 0 0 0 0 0 0 0 0 0 0 0 0 0 0 0 0 0 0 0 0 0 0 0 0 0 0 0 0 0 0
0 0 0 0 0 0 0  0 0 0 0  0 0 0 0 0 0  0 0  0 0  0 0  0 0  0 0 0 0  0 0  0 0 0 0  0 0 0 0  0 0 0 0 0 0  0 0 0 0  0 0  0 0 0  0 0  0 0 0  0 0  0 0 0  0 0  0 0 0 0  0 0 0 0  0 0 0 0 0 0 0 0 0 0 0 0 0 0 0 0 0 0 0 0 0 0 0 0 0 0 0 0 0 0 0 0 0 0 0 0 0 0 0 0 0 0 0 0 0 0 0 0 0 0 0 0 0 0 0 0 0 0 0 0 0 0 0 0 0 0 0 0 0 0 0 0 0 0 0 0 0 0 0 0 0 0 0 0 0 0 0 0 0 0 0 0 0 0 0 0 0 0 0 0 0 0 0 0 0 0 0 0 0 0 0 0 0 0 0 0 0 0 0 0 0 0 0 0 0 0
0 0 0 0 0 0 0  0 0 0 0  0 0 0 0 0 0  0 0  0 0  0 0  0 0  0 0 0 0  0 0  0 0 0 0  0 0 0 0  0 0 0 0 0 0  0 0 0 0  0 0  0 0 0  0 0  0 0 0  0 0  0 0 0  0 0  0 0 0 0  0 0 0 0  0 0 0 0 0 0 0 0 0 0 0 0 0 0 0 0 0 0 0 0 0 0 0 0 0 0 0 0 0 0 0 0 0 0 0 0 0 0 0 0 0 0 0 0 0 0 0 0 0 0 0 0 0 0 0 0 0 0 0 0 0 0 0 0 0 0 0 0 0 0 0 0 0 0 0 0 0 0 0 0 0 0 0 0 0 0 0 0 0 0 0 0 0 0 0 0 0 0 0 0 0 0 0 0 0 0 0 0 0 0 0 0 0 0 0 0 0 0 0 0 0 0 0 0 0 0
0 0 0 0 0 0 0  0 0 0 0  0 0 0 0 0 0  0 0  0 0  0 0  0 0  0 0 0 0  0 0  0 0 0 0  0 0 0 0  0 0 0 0 0 0  0 0 0 0  0 0  0 0 0  0 0  0 0 0  0 0  0 0 0  0 0  0 0 0 0  0 0 0 0  0 0 0 0 0 0 0 0 0 0 0 0 0 0 0 0 0 0 0 0 0 0 0 0 0 0 0 0 0 0 0 0 0 0 0 0 0 0 0 0 0 0 0 0 0 0 0 0 0 0 0 0 0 0 0 0 0 0 0 0 0 0 0 0 0 0 0 0 0 0 0 0 0 0 0 0 0 0 0 0 0 0 0 0 0 0 0 0 0 0 0 0 0 0 0 0 0 0 0 0 0 0 0 0 0 0 0 0 0 0 0 0 0 0 0 0 0 0 0 0 0 0 0 0 0 0
0 0 0 0 0 0 0  0 0 0 0  0 0 0 0 0 0  0 0  0 0  0 0  0 0  0 0 0 0  0 0  0 0 0 0  0 0 0 0  0 0 0 0 0 0  0 0 0 0  0 0  0 0 0  0 0  0 0 0  0 0  0 0 0  0 0  0 0 0 0  0 0 0 0  0 0 0 0 0 0 0 0 0 0 0 0 0 0 0 0 0 0 0 0 0 0 0 0 0 0 0 0 0 0 0 0 0 0 0 0 0 0 0 0 0 0 0 0 0 0 0 0 0 0 0 0 0 0 0 0 0 0 0 0 0 0 0 0 0 0 0 0 0 0 0 0 0 0 0 0 0 0 0 0 0 0 0 0 0 0 0 0 0 0 0 0 0 0 0 0 0 0 0 0 0 0 0 0 0 0 0 0 0 0 0 0 0 0 0 0 0 0 0 0 0 0 0 0 0 0
0 0 0 0 0 0 0  0 0 0 0  0 0 0 0 0 0  0 0  0 0  0 0  0 0  0 0 0 0  0 0  0 0 0 0  0 0 0 0  0 0 0 0 0 0  0 0 0 0  0 0  0 0 0  0 0  0 0 0  0 0  0 0 0  0 0  0 0 0 0  0 0 0 0  0 0 0 0 0 0 0 0 0 0 0 0 0 0 0 0 0 0 0 0 0 0 0 0 0 0 0 0 0 0 0 0 0 0 0 0 0 0 0 0 0 0 0 0 0 0 0 0 0 0 0 0 0 0 0 0 0 0 0 0 0 0 0 0 0 0 0 0 0 0 0 0 0 0 0 0 0 0 0 0 0 0 0 0 0 0 0 0 0 0 0 0 0 0 0 0 0 0 0 0 0 0 0 0 0 0 0 0 0 0 0 0 0 0 0 0 0 0 0 0 0 0 0 0 0 0
0 0 0 0 0 0 0  0 0 0 0  0 0 0 0 0 0  0 0  0 0  0 0  0 0  0 0 0 0  0 0  0 0 0 0  0 0 0 22 1 1 1 1 1 23 0 0 0 0  0 0  0 0 0  0 0  0 0 0  0 0  0 0 0  0 0  0 0 0 0  0 0 0 0  0 0 0 0 0 0 0 0 0 0 0 0 0 0 0 0 0 0 0 0 0 0 0 0 0 0 0 0 0 0 0 0 0 0 0 0 0 0 0 0 0 0 0 0 0 0 0 0 0 0 0 0 0 0 0 0 0 0 0 0 0 0 0 0 0 0 0 0 0 0 0 0 0 0 0 0 0 0 0 0 0 0 0 0 0 0 0 0 0 0 0 0 0 0 0 0 0 0 0 0 0 0 0 0 0 0 0 0 0 0 0 0 0 0 0 0 0 0 0 0 0 0 0 0 0 0
0 0 0 0 0 0 0  0 0 0 0  0 0 0 0 0 0  0 0  0 0  0 0  0 0  0 0 0 0  0 0  0 0 0 0  0 0 0 29 2 2 2 2 2 30 0 0 0 22 1 23 0 0 0  0 0  0 0 0  0 0  0 0 0  0 0  0 0 0 0  0 0 0 0  0 0 0 0 0 0 0 0 0 0 0 0 0 0 0 0 0 0 0 0 0 0 0 0 0 0 0 0 0 0 0 0 0 0 0 0 0 0 0 0 0 0 0 0 0 0 0 0 0 0 0 0 0 0 0 0 0 0 0 0 0 0 0 0 0 0 0 0 0 0 0 0 0 0 0 0 0 0 0 0 0 0 0 0 0 0 0 0 0 0 0 0 0 0 0 0 0 0 0 0 0 0 0 0 0 0 0 0 0 0 0 0 0 0 0 0 0 0 0 0 0 0 0 0 0 0
0 0 0 0 0 0 0  0 0 0 0  0 0 0 0 0 0  0 0  0 0  0 0  0 0  0 0 0 0  0 0  0 0 0 22 1 1 1 1  7 2 2 2 2 30 0 0 0 29 2 30 0 0 22 1 23 0 0 0  0 0  0 0 0  0 0  0 0 0 0  0 0 0 0  0 0 0 0 0 0 0 0 0 0 0 0 0 0 0 0 0 0 0 0 0 0 0 0 0 0 0 0 0 0 0 0 0 0 0 0 0 0 0 0 0 0 0 0 0 0 0 0 0 0 0 0 0 0 0 0 0 0 0 0 0 0 0 0 0 0 0 0 0 0 0 0 0 0 0 0 0 0 0 0 0 0 0 0 0 0 0 0 0 0 0 0 0 0 0 0 0 0 0 0 0 0 0 0 0 0 0 0 0 0 0 0 0 0 0 0 0 0 0 0 0 0 0 0 0 0
0 0 0 0 0 0 0  0 0 0 0  0 0 0 0 0 0  0 0  0 0  0 0  0 0  0 0 0 0  0 0  0 0 0 29 2 2 2 2  2 2 2 2 2 30 0 0 0 29 2 30 0 0 29 2 30 0 0 22 1 23 0 0 0  0 0  0 0 0 0  0 0 0 0  0 0 0 0 0 0 0 0 0 0 0 0 0 0 0 0 0 0 0 0 0 0 0 0 0 0 0 0 0 0 0 0 0 0 0 0 0 0 0 0 0 0 0 0 0 0 0 0 0 0 0 0 0 0 0 0 0 0 0 0 0 0 0 0 0 0 0 0 0 0 0 0 0 0 0 0 0 0 0 0 0 0 0 0 0 0 0 0 0 0 0 0 0 0 0 0 0 0 0 0 0 0 0 0 0 0 0 0 0 0 0 0 0 0 0 0 0 0 0 0 0 0 0 0 0 0
0 0 0 0 0 0 0  0 0 0 0  0 0 0 0 0 0  0 0  0 0  0 0  0 0  0 0 0 0  0 22 1 1 1 1  7 2 2 2  2 2 2 2 6 1  1 1 1 1  7 30 0 0 29 2 30 0 0 29 2 30 0 0 22 1 23 0 0 0 0  0 0 0 0  0 0 0 0 0 0 0 0 0 0 0 0 0 0 0 0 0 0 0 0 0 0 0 0 0 0 0 0 0 0 0 0 0 0 0 0 0 0 0 0 0 0 0 0 0 0 0 0 0 0 0 0 0 0 0 0 0 0 0 0 0 0 0 0 0 0 0 0 0 0 0 0 0 0 0 0 0 0 0 0 0 0 0 0 0 0 0 0 0 0 0 0 0 0 0 0 0 0 0 0 0 0 0 0 0 0 0 0 0 0 0 0 0 0 0 0 0 0 0 0 0 0 0 0 0 0
0 0 0 0 0 0 0  0 0 0 0  0 0 0 0 0 0  0 0  0 0  0 0  0 24 3 4 5 25 0 29 2 2 2 2  2 2 2 2  2 2 2 2 2 2  2 2 2 2  2 30 0 0 29 2 30 0 0 29 2 30 0 0 29 2 30 0 0 0 22 1 1 1 23 0 0 0 0 0 0 0 0 0 0 0 0 0 0 0 0 0 0 0 0 0 0 0 0 0 0 0 0 0 0 0 0 0 0 0 0 0 0 0 0 0 0 0 0 0 0 0 0 0 0 0 0 0 0 0 0 0 0 0 0 0 0 0 0 0 0 0 0 0 0 0 0 0 0 0 0 0 0 0 0 0 0 0 0 0 0 0 0 0 0 0 0 0 0 0 0 0 0 0 0 0 0 0 0 0 0 0 0 0 0 0 0 0 0 0 0 0 0 0 0 0 0 0 0 0 0
0 0 0 0 0 0 0  0 0 0 0  0 0 0 0 0 0  0 0  0 0  0 0  0 0  0 0 0 0  0 29 2 2 2 2  2 2 2 2  2 2 2 2 2 2  2 2 2 2  2 30 0 0 29 2 30 0 0 29 2 30 0 0 29 2 30 0 0 0 29 2 2 2 30 0 0 0 0 0 0 0 0 0 0 0 0 0 0 0 0 0 0 0 0 0 0 0 0 0 0 0 0 0 0 0 0 0 0 0 0 0 0 0 0 0 0 0 0 0 0 0 0 0 0 0 0 0 0 0 0 0 0 0 0 0 0 0 0 0 0 0 0 0 0 0 0 0 0 0 0 0 0 0 0 0 0 0 0 0 0 0 0 0 0 0 0 0 0 0 0 0 0 0 0 0 0 0 0 0 0 0 0 0 0 0 0 0 0 0 0 0 0 0 0 0 0 0 0 0 0
0 0 0 0 0 0 0  0 0 0 0  0 0 0 0 0 0  0 24 3 4  5 25 0 0  0 0 0 0  0 29 2 2 2 2  2 2 2 2  2 2 2 2 2 2  2 2 2 2  2 30 0 0 29 2 30 0 0 29 2 30 0 0 29 2 30 0 0 0 29 2 2 2 30 0 0 0 0 0 0 0 0 0 0 0 0 0 0 0 0 0 0 0 0 0 0 0 0 0 0 0 0 0 0 0 0 0 0 0 0 0 0 0 0 0 0 0 0 0 0 0 0 0 0 0 0 0 0 0 0 0 0 0 0 0 0 0 0 0 0 0 0 0 0 0 0 0 0 0 0 0 0 0 0 0 0 0 0 0 0 0 0 0 0 0 0 0 0 0 0 0 0 0 0 0 0 0 0 0 0 0 0 0 0 0 0 0 0 0 0 0 0 0 0 0 0 0 0 0 0
0 0 0 0 0 0 0  0 0 0 0  0 0 0 0 0 0  0 0  0 0  0 0  0 0  0 0 0 0  0 29 2 2 2 2  2 2 2 2  2 2 2 2 2 2  2 2 2 2  2 30 0 0 29 2 30 0 0 29 2 30 0 0 29 2 30 0 0 0 29 2 2 2 30 0 0 0 0 0 0 0 0 0 0 0 0 0 0 0 0 0 0 0 0 0 0 0 0 0 0 0 0 0 0 0 0 0 0 0 0 0 0 0 0 0 0 0 0 0 0 0 0 0 0 0 0 0 0 0 0 0 0 0 0 0 0 0 0 0 0 0 0 0 0 0 0 0 0 0 0 0 0 0 0 0 0 0 0 0 0 0 0 0 0 0 0 0 0 0 0 0 0 0 0 0 0 0 0 0 0 0 0 0 0 0 0 0 0 0 0 0 0 0 0 0 0 0 0 0 0
0 0 0 0 0 0 0  0 0 0 0  0 0 0 0 0 0  0 0  0 0  0 0  0 24 3 4 5 25 0 29 2 2 2 2  2 2 2 2  2 2 2 2 2 2  2 2 2 2  2 30 0 0 29 2 30 0 0 29 2 30 0 0 29 2 30 0 0 0 29 2 2 2 30 0 0 0 0 0 0 0 0 0 0 0 0 0 0 0 0 0 0 0 0 0 0 0 0 0 0 0 0 0 0 0 0 0 0 0 0 0 0 0 0 0 0 0 0 0 0 0 0 0 0 0 0 0 0 0 0 0 0 0 0 0 0 0 0 0 0 0 0 0 0 0 0 0 0 0 0 0 0 0 0 0 0 0 0 0 0 0 0 0 0 0 0 0 0 0 0 0 0 0 0 0 0 0 0 0 0 0 0 0 0 0 0 0 0 0 0 0 0 0 0 0 0 0 0 0 0
0 0 0 0 0 0 0  0 0 0 0  0 0 0 0 0 0  0 0  0 26 0 0  0 0  0 0 0 0  0 29 2 2 2 2  2 2 2 2  2 2 2 2 2 2  2 2 2 2  2 30 0 0 29 2 30 0 0 29 2 30 0 0 29 2 30 0 0 0 29 2 2 2 30 0 0 0 0 0 0 0 0 0 0 0 0 0 0 0 0 0 0 0 0 0 0 0 0 0 0 0 0 0 0 0 0 0 0 0 0 0 0 0 0 0 0 0 0 0 0 0 0 0 0 0 0 0 0 0 0 0 0 0 0 0 0 0 0 0 0 0 0 0 0 0 0 0 0 0 0 0 0 0 0 0 0 0 0 0 0 0 0 0 0 0 0 0 0 0 0 0 0 0 0 0 0 0 0 0 0 0 0 0 0 0 0 0 0 0 0 0 0 0 0 0 0 0 0 0 0
0 0 0 0 0 0 0  0 0 0 0  0 0 0 0 0 0  0 24 3 4  5 25 0 0  0 0 0 0  0 29 2 2 2 2  2 2 2 2  2 2 2 2 2 2  2 2 2 2  2 30 0 0 29 2 30 0 0 29 2 30 0 0 29 2 30 0 0 0 29 2 2 2 30 0 0 0 0 0 0 0 0 0 0 0 0 0 0 0 0 0 0 0 0 0 0 0 0 0 0 0 0 0 0 0 0 0 0 0 0 0 0 0 0 0 0 0 0 0 0 0 0 0 0 0 0 0 0 0 0 0 0 0 0 0 0 0 0 0 0 0 0 0 0 0 0 0 0 0 0 0 0 0 0 0 0 0 0 0 0 0 0 0 0 0 0 0 0 0 0 0 0 0 0 0 0 0 0 0 0 0 0 0 0 0 0 0 0 0 0 0 0 0 0 0 0 0 0 0 0
0 0 0 0 0 0 0  0 0 0 0  0 0 0 0 0 0  0 0  0 0  0 0  0 0  0 0 0 0  0 29 2 2 2 2  2 2 2 2  2 2 2 2 2 2  2 2 2 2  2 30 0 0 29 2 30 0 0 29 2 30 0 0 29 2 30 0 0 0 29 2 2 2 30 0 0 0 0 0 0 0 0 0 0 0 0 0 0 0 0 0 0 0 0 0 0 0 0 0 0 0 0 0 0 0 0 0 0 0 0 0 0 0 0 0 0 0 0 0 0 0 0 0 0 0 0 0 0 0 0 0 0 0 0 0 0 0 0 0 0 0 0 0 0 0 0 0 0 0 0 0 0 0 0 0 0 0 0 0 0 0 0 0 0 0 0 0 0 0 0 0 0 0 0 0 0 0 0 0 0 0 0 0 0 0 0 0 0 0 0 0 0 0 0 0 0 0 0 0 0
0 0 0 0 0 0 0  0 0 0 0  0 0 0 0 0 0  0 0  0 0  0 0  0 24 3 4 5 25 0 29 2 2 2 2  2 2 2 2  2 2 2 2 2 2  2 2 2 2  2 30 0 0 29 2 30 0 0 29 2 30 0 0 29 2 30 0 0 0 29 2 2 2 30 0 0 0 0 0 0 0 0 0 0 0 0 0 0 0 0 0 0 0 0 0 0 0 0 0 0 0 0 0 0 0 0 0 0 0 0 0 0 0 0 0 0 0 0 0 0 0 0 0 0 0 0 0 0 0 0 0 0 0 0 0 0 0 0 0 0 0 0 0 0 0 0 0 0 0 0 0 0 0 0 0 0 0 0 0 0 0 0 0 0 0 0 0 0 0 0 0 0 0 0 0 0 0 0 0 0 0 0 0 0 0 0 0 0 0 0 0 0 0 0 0 0 0 0 0 0
0 0 0 0 0 0 0  0 0 0 0  0 0 0 0 0 0  0 0  0 0  0 0  0 0  0 0 0 0  0 29 2 2 2 2  2 2 2 2  2 2 2 2 2 2  2 2 2 2  2 30 0 0 29 2 30 0 0 29 2 30 0 0 29 2 30 0 0 0 29 2 2 2 30 0 0 0 0 0 0 0 0 0 0 0 0 0 0 0 0 0 0 0 0 0 0 0 0 0 0 0 0 0 0 0 0 0 0 0 0 0 0 0 0 0 0 0 0 0 0 0 0 0 0 0 0 0 0 0 0 0 0 0 0 0 0 0 0 0 0 0 0 0 0 0 0 0 0 0 0 0 0 0 0 0 0 0 0 0 0 0 0 0 0 0 0 0 0 0 0 0 0 0 0 0 0 0 0 0 0 0 0 0 0 0 0 0 0 0 0 0 0 0 0 0 0 0 0 0 0
0 0 0 0 0 0 0  0 0 0 27 0 0 0 0 0 0  0 24 3 4  5 25 0 0  0 0 0 0  0 29 2 2 2 2  2 2 2 2  2 2 2 2 2 2  2 2 2 2  2 30 0 0 29 2 30 0 0 29 2 30 0 0 29 2 30 0 0 0 29 2 2 2 30 0 0 0 0 0 0 0 0 0 0 0 0 0 0 0 0 0 0 0 0 0 0 0 0 0 0 0 0 0 0 0 0 0 0 0 0 0 0 0 0 0 0 0 0 0 0 0 0 0 0 0 0 0 0 0 0 0 0 0 0 0 0 0 0 0 0 0 0 0 0 0 0 0 0 0 0 0 0 0 0 0 0 0 0 0 0 0 0 0 0 0 0 0 0 0 0 0 0 0 0 0 0 0 0 0 0 0 0 0 0 0 0 0 0 0 0 0 0 0 0 0 0 0 0 0 0
0 0 0 0 0 0 22 1 1 1 1  1 1 1 1 1 23 0 0  0 0  0 0  0 0  0 0 0 0  0 29 2 2 2 2  2 2 2 2  2 2 2 2 2 2  2 2 2 2  2 30 0 0 29 2 30 0 0 29 2 30 0 0 29 2 30 0 0 0 29 2 2 2 30 0 0 0 0 0 0 0 0 0 0 0 0 0 0 0 0 0 0 0 0 0 0 0 0 0 0 0 0 0 0 0 0 0 0 0 0 0 0 0 0 0 0 0 0 0 0 0 0 0 0 0 0 0 0 0 0 0 0 0 0 0 0 0 0 0 0 0 0 0 0 0 0 0 0 0 0 0 0 0 0 0 0 0 0 0 0 0 0 0 0 0 0 0 0 0 0 0 0 0 0 0 0 0 0 0 0 0 0 0 0 0 0 0 0 0 0 0 0 0 0 0 0 0 0 0 0
0 0 0 0 0 0 29 2 2 2 2  2 2 2 2 2 30 0 0  0 0  0 0  0 0  0 0 0 0  0 29 2 2 2 2  2 2 2 2  2 2 2 2 2 2  2 2 2 2  2 30 0 0 29 2 30 0 0 29 2 30 0 0 29 2 30 0 0 0 29 2 2 2 30 0 0 0 0 0 0 0 0 0 0 0 0 0 0 0 0 0 0 0 0 0 0 0 0 0 0 0 0 0 0 0 0 0 0 0 0 0 0 0 0 0 0 0 0 0 0 0 0 0 0 0 0 0 0 0 0 0 0 0 0 0 0 0 0 0 0 0 0 0 0 0 0 0 0 0 0 0 0 0 0 0 0 0 0 0 0 0 0 0 0 0 0 0 0 0 0 0 0 0 0 0 0 0 0 0 0 0 0 0 0 0 0 0 0 0 0 0 0 0 0 0 0 0 0 0 0
0 0 0 0 0 0 29 2 2 2 2  2 2 2 2 2 30 0 0  0 0  0 0  0 0  0 0 0 0  0 29 2 2 2 2  2 2 2 2  2 2 2 2 2 2  2 2 2 2  2 30 0 0 29 2 30 0 0 29 2 30 0 0 29 2 30 0 0 0 29 2 2 2 30 0 0 0 0 0 0 0 0 0 0 0 0 0 0 0 0 0 0 0 0 0 0 0 0 0 0 0 0 0 0 0 0 0 0 0 0 0 0 0 0 0 0 0 0 0 0 0 0 0 0 0 0 0 0 0 0 0 0 0 0 0 0 0 0 0 0 0 0 0 0 0 0 0 0 0 0 0 0 0 0 0 0 0 0 0 0 0 0 0 0 0 0 0 0 0 0 0 0 0 0 0 0 0 0 0 0 0 0 0 0 0 0 0 0 0 0 0 0 0 0 0 0 0 0 0 0
1 1 1 1 1 1 1  7 2 2 2  2 2 2 2 2 30 0 0  0 0  0 0  0 0  0 0 0 0  0 29 2 2 2 2  2 2 2 2  2 2 2 2 2 2  2 2 2 2  2 30 0 0 29 2 30 0 0 29 2 30 0 0 29 2 30 0 0 0 29 2 2 2 30 0 0 0 0 0 0 0 0 0 0 0 0 0 0 0 0 0 0 0 0 0 0 0 0 0 0 0 0 0 0 0 0 0 0 0 0 0 0 0 0 0 0 0 0 0 0 0 0 0 0 0 0 0 0 0 0 0 0 0 0 0 0 0 0 0 0 0 0 0 0 0 0 0 0 0 0 0 0 0 0 0 0 0 0 0 0 0 0 0 0 0 0 0 0 0 0 0 0 0 0 0 0 0 0 0 0 0 0 0 0 0 0 0 0 0 0 0 0 0 0 0 0 0 0 0 0
2 2 2 2 2 2 2  2 2 2 2  2 2 2 2 2 30 0 0  0 0  0 0  0 0  0 0 0 0  0 29 2 2 2 2  2 2 2 2  2 2 2 2 2 2  2 2 2 2  2 30 0 0 29 2 30 0 0 29 2 30 0 0 29 2 30 0 0 0 29 2 2 2 30 0 0 0 0 0 0 0 0 0 0 0 0 0 0 0 0 0 0 0 0 0 0 0 0 0 0 0 0 0 0 0 0 0 0 0 0 0 0 0 0 0 0 0 0 0 0 0 0 0 0 0 0 0 0 0 0 0 0 0 0 0 0 0 0 0 0 0 0 0 0 0 0 0 0 0 0 0 0 0 0 0 0 0 0 0 0 0 0 0 0 0 0 0 0 0 0 0 0 0 0 0 0 0 0 0 0 0 0 0 0 0 0 0 0 0 0 0 0 0 0 0 0 0 0 0 0