170
18
2 2 2 30 0 0  0 0  0 0  0 0  0  0 0  0 0  0 0 0 0 0  0 0 0 0 0  0 0  0 0 0  0  0 0  0  0  0  0  0  0  0  0 0  0  0  0  0  0  0  0 0   0  0 0  0 0 0  0 0 0  0  0  0  0 0 0  0  0 0 0 0  0  0 0  0  0  0 0  0 0  0 0 0  0 0 0  0 0 0  0 0 0 0  0  0 0 0 0  0 0 0 0 0 0  0 0  0 0  0 0  0 0  0 0  0 0  0  0 0 0 0  0  0  0 0  0  0  0  0 0 0 0  0  0  0 0 0 0  0 0  0 0 0 0  0  0 0  0 0 0  0  0 0 0  0 0 0 0 0 0  0 0 0 0 0 0 0 0 0 
2 2 2 30 0 0  0 0  0 0  0 0  0  0 0  0 0  0 0 0 0 0  0 0 0 0 0  0 0  0 0 0  0  0 0  0  0  0  0  0  0  0  0 0  0  0  0  0  0  0  0 0   0  0 0  0 0 0  0 0 0  0  0  0  0 0 0  0  0 0 0 0  0  0 0  0  0  0 0  0 0  0 0 0  0 0 0  0 0 0  0 0 0 0  0  0 0 0 0  0 0 0 0 0 0  0 0  0 0  0 0  0 0  0 0  0 0  0  0 0 0 0  0  0  0 0  0  0  0  0 0 0 0  0  0  0 0 0 0  0 0  0 0 0 0  0  0 0  0 0 0  0  0 0 0  0 0 0 0 0 0  0 0 0 0 0 0 0 0 0 
2 2 2 30 0 0  0 0  0 0  0 0  0  0 0  0 0  0 0 0 0 0  0 0 0 0 0  0 0  0 0 0  0  0 0  0  0  0  0  0  0  0  0 0  0  0  0  0  0  0  0 0   0  0 0  0 0 0  0 0 0  0  0  0  0 0 0  0  0 0 0 0  0  0 0  0  0  0 0  0 0  0 0 0  0 0 0  0 0 0  0 0 0 0  0  0 0 0 0  0 0 0 0 0 0  0 0  0 0  0 0  0 0  0 0  0 0  0  0 0 0 0  0  0  0 0  0  0  0  0 0 0 0  0  0  0 0 0 0  0 0  0 0 0 0  0  0 0  0 0 0  0  0 0 0  0 0 0 0 0 0  0 0 0 0 0 0 0 0 0 
2 2 2 30 0 0  0 0  0 0  0 0  0  0 0  0 0  0 0 0 0 0  0 0 0 0 0  0 0  0 0 0  0  0 0  0  0  0  0  0  0  0  0 0  0  0  0  0  0  0  0 0   0  0 0  0 0 0  0 0 0  0  0  0  0 0 0  0  0 0 0 0  0  0 0  0  0  0 0  0 0  0 0 0  0 0 0  0 0 0  0 0 0 0  0  0 0 0 0  0 0 0 0 0 0  0 0  0 0  0 0  0 0  0 0  0 0  0  0 0 0 0  0  0  0 0  0  0  0  0 0 0 0  0  0  0 0 0 0  0 0  0 0 0 0  0  0 0  0 0 0  0  0 0 0  0 0 0 0 0 0  0 0 0 0 0 0 0 0 0 
2 2 2 30 0 0  0 0  0 0  0 0  0  0 0  0 0  0 0 0 0 0  0 0 0 0 0  0 0  0 0 0  0  0 0  0  0  0  0  0  0  0  0 0  0  0  0  0  0  0  0 0   0  0 0  0 0 0  0 0 0  0  0  0  0 0 0  0  0 0 0 0  0  0 0  0  0  0 0  0 0  0 0 0  0 0 0  0 0 0  0 0 0 0  0  0 0 0 0  0 0 0 0 0 0  0 0  0 0  0 0  0 0  0 0  0 0  0  0 0 0 0  0  0  0 0  0  0  0  0 0 0 0  0  0  0 0 0 0  0 0  0 0 0 0  0  0 0  0 0 0  0  0 0 0  0 0 0 0 0 0  0 0 0 0 0 0 0 0 0 
2 2 2 30 0 0  0 0  0 0  0 0  0  0 0  0 0  0 0 0 0 0  0 0 0 0 0  0 0  0 0 0  0  0 0  0  0  0  0  0  0  0  0 0  0  0  0  0  0  0  0 0   0  0 0  0 0 0  0 0 0  0  0  0  0 0 0  0  0 0 0 0  0  0 0  0  0  0 0  0 0  0 0 0  0 0 0  0 0 0  0 0 0 0  0  0 0 0 0  0 0 0 0 0 0  0 0  0 0  0 0  0 41 0 0  0 0  0  0 0 0 0  0  0  0 0  0  0  0  0 0 0 0  0  0  0 0 0 0  0 0  0 0 0 0  0  0 0  0 0 0  0  0 0 0  0 0 0 0 0 0  0 0 0 0 0 0 0 0 0 
2 2 2 30 0 0  0 0  0 0  0 0  0  0 0  0 0  0 0 0 0 0  0 0 0 0 0  0 0  0 0 0  0  0 0  0  0  0  0  0  0  0  0 0  0  0  0  0  0  0  0 0   0  0 0  0 0 0  0 0 0  0  0  0  0 0 0  0  0 0 0 0  0  0 0  0  0  0 0  0 0  0 0 0  0 0 0  0 0 0  0 0 0 0  0  0 0 0 0  0 0 0 0 0 0  0 0  0 0  0 0  0 0  0 0  0 0  22 1 1 1 1  23 0  0 0  0  0  0  0 0 0 0  0  0  0 0 0 0  0 0  0 0 0 0  0  0 0  0 0 0  0  0 0 0  0 0 0 0 0 0  0 0 0 0 0 0 0 0 0 
2 2 2 30 0 0  0 0  0 0  0 0  0  0 0  0 0  0 0 0 0 0  0 0 0 0 0  0 0  0 0 0  0  0 0  0  0  0  0  0  0  0  0 0  0  0  0  0  0  0  0 0   0  0 0  0 0 0  0 0 0  0  0  0  0 0 0  0  0 0 0 0  0  0 0  0  0  0 0  0 0  0 0 0  0 0 0  0 0 0  0 0 0 0  0  0 0 0 0  0 0 0 0 0 0  0 0  0 0  0 0  0 0  0 0  0 0  29 2 2 2 2  30 0  0 0  0  0  0  0 0 0 0  0  0  0 0 0 0  0 0  0 0 0 0  0  0 0  0 0 0  0  0 0 0  0 0 0 0 0 0  0 0 0 0 0 0 0 0 0 
2 2 2 30 0 0  0 0  0 0  0 0  0  0 0  0 0  0 0 0 0 0  0 0 0 0 0  0 0  0 0 0  0  0 0  0  0  0  0  0  0  26 0 0  0  0  0  0  0  0  0 0   0  0 0  0 0 0  0 0 0  0  0  0  0 0 0  0  0 0 0 0  0  0 0  0  0  0 0  0 0  0 0 0  0 0 0  0 0 0  0 0 0 0  0  0 0 0 0  0 0 0 0 0 0  0 0  0 0  0 0  0 0  0 0  0 0  29 2 2 2 2  30 0  0 0  0  0  0  0 0 0 0  0  0  0 0 0 0  0 0  0 0 0 0  0  0 0  0 0 0  0  0 0 0  0 0 0 0 0 0  0 0 0 0 0 0 0 0 0 
2 2 2 30 0 0  0 0  0 0  0 0  0  0 0  0 0  0 0 0 0 0  0 0 0 0 0  0 0  0 0 0  0  0 0  0  0  0  0  0  22 1  1 23 0  0  0  0  0  0  0 0   0  0 0  0 0 0  0 0 0  0  0  0  0 0 0  0  0 0 0 0  0  0 0  0  0  0 0  0 0  0 0 0  0 0 0  0 0 0  0 0 0 0  0  0 0 0 0  0 0 0 0 0 0  0 0  0 0  0 0  0 0  0 0  0 0  29 2 2 2 2  30 0  0 0  0  0  0  0 0 0 0  0  0  0 0 0 0  0 0  0 0 0 0  0  0 0  0 0 0  0  0 0 0  0 0 0 0 0 0  0 0 0 0 0 0 0 0 0 
2 2 2 30 0 0  0 0  0 0  0 0  0  0 0  0 0  0 0 0 0 0  0 0 0 0 0  0 0  0 0 0  0  0 0  0  0  0  0  22 1  7  6 1  23 0  0  0  0  37 0 35  36 0 0  0 0 0  0 0 0  0  0  0  0 0 0  0  0 0 0 0  0  0 39 0  0  0 0  0 0  0 0 0  0 0 0  0 0 0  0 0 0 0  40 0 0 0 0  0 0 0 0 0 0  0 0  0 0  0 22 1 1  1 23 0 0  29 2 2 2 2  30 0  0 0  0  0  0  0 0 0 0  0  0  0 0 0 0  0 0  0 0 0 0  0  0 0  0 0 0  0  0 0 0  0 0 0 0 0 0  0 0 0 0 0 0 0 0 0 
2 2 2 30 0 0  0 34 0 0  0 0  36 0 0  0 0  0 0 0 0 26 0 0 0 0 0  0 0  0 0 38 0  0 0  0  0  0  22 1  7  2  2 6  1  23 0  0  0  0  0 0   0  0 0  0 0 0  0 0 0  0  0  0  0 0 0  24 3 4 5 25 0  0 0  0  0  0 0  0 0  0 0 0  0 0 0  0 0 0  0 0 0 0  0  0 0 0 0  0 0 0 0 0 0  0 0  0 22 1 1  7 2  6 1  1 23 29 2 2 2 2  30 26 0 0  0  0  0  0 0 0 0  0  0  0 0 0 0  0 0  0 0 0 0  0  0 0  0 0 0  0  0 0 0  0 0 0 0 0 0  0 0 0 0 0 0 0 0 0 
2 2 2 30 0 0  0 0  0 0  0 0  0  0 0  0 22 1 1 1 1 1  1 1 1 1 23 0 0  0 0 0  0  0 0  0  0  22 1  7  2  2  2 2  6  1  23 0  0  0  0 0   0  0 0  0 0 0  0 0 0  0  0  26 0 0 0  0  0 0 0 0  0  0 0  0  0  0 0  0 0  0 0 0  0 0 0  0 0 0  0 0 0 0  0  0 0 0 0  0 0 0 0 0 0  0 22 1 1  7 2  2 2  2 2  6 1  1  7 2 2 6  1  1  1 1  23 0  0  0 0 0 0  0  24 3 4 5 25 0 24 3 4 5 25 0  0 0  0 0 27 0  0 0 0  0 0 0 0 0 0  0 0 0 0 0 0 0 0 0 
2 2 2 30 0 0  0 0  0 0  0 0  0  0 0  0 29 2 2 2 2 2  2 2 2 2 30 0 0  0 0 0  0  0 0  0  22 1  7  2  2  2  2 2  2  6  1  23 0  0  0 0   0  0 0  0 0 0  0 0 0  0  24 3  4 5 25 0  0 0 0 0  0  0 0  0  0  0 0  0 0  0 0 0  0 0 0  0 0 0  0 0 0 0  0  0 0 0 0  0 0 0 0 0 22 1 1  7 2  2 2  2 2  2 2  2 2  2  2 2 2 2  2  2  2 2  30 0  0  0 0 0 0  0  0  0 0 0 0  0 0  0 0 0 0  0  0 24 3 4 5  25 0 0 22 1 1 1 1 1 23 0 0 0 0 0 0 0 0 0 
2 2 2 30 0 0  0 0  0 0  0 0  0  0 22 1 1  7 2 2 2 2  2 2 2 6 1  1 23 0 0 0  0  0 0  22 1  7  2  2  2  2  2 2  2  2  6  1  23 0  0 26  27 0 0  0 0 0  0 0 0  0  0  0  0 0 0  0  0 0 0 0  0  0 0  27 0  0 0  0 27 0 0 0  0 0 0  0 0 0  0 0 0 0  0  0 0 0 22 1 1 1 1 1 1  7 2  2 2  2 2  2 2  2 2  2 2  2  2 2 2 2  2  2  2 2  30 0  24 3 4 5 25 0  0  0 0 0 0  0 0  0 0 0 0  0  0 0  0 0 0  0  0 0 29 2 2 2 2 2 30 0 0 0 0 0 0 0 0 0 
2 2 2 30 0 27 0 26 0 0  0 0  0  0 29 2 2  2 2 2 2 2  2 2 2 2 2  2 30 0 0 0  27 0 22 1  7  2  2  2  2  2  2 2  2  2  2  6  1  1  1 1   1  1 23 0 0 22 1 1 23 0  0  0  0 0 0  0  0 0 0 0  24 3 4  5  25 0 22 1 1  1 1 23 0 0 22 1 1 23 0 0 0 22 1  1 1 1 1  7 2 2 2 2 2  2 2  2 2  2 2  2 2  2 2  2 2  2  2 2 2 2  2  2  2 2  30 0  0  0 0 0 0  0  0  0 0 0 0  0 0  0 0 0 0  0  0 0  0 0 0  0  0 0 29 2 2 2 2 2 30 0 0 0 0 0 0 0 0 0 
2 2 6 1  1 1  1 1  1 1  1 1  1  1 1  7 2  2 2 2 2 2  2 2 2 2 2  6 1  1 1 1  1  1 1  7  2  2  2  2  2  2  2 2  2  2  2  2  2  2  2 2   2  2 30 0 0 29 2 2 30 0  0  0  0 0 0  0  0 0 0 0  0  0 0  0  0  0 29 2 2  2 2 30 0 0 29 2 2 30 0 0 0 29 2  2 2 2 2  2 2 2 2 2 2  2 2  2 2  2 2  2 2  2 2  2 2  2  2 2 2 2  2  2  2 2  30 0  0  0 0 0 0  0  0  0 0 0 0  0 0  0 0 0 0  0  0 0  0 0 0  0  0 0 29 2 2 2 2 2 30 0 0 0 0 0 0 0 0 0 
2 2 2 2  2 2  2 2  2 2  2 2  2  2 2  2 2  2 2 2 2 2  2 2 2 2 2  2 2  2 2 2  2  2 2  2  2  2  2  2  2  2  2 2  2  2  2  2  2  2  2 2   2  2 30 0 0 29 2 2 30 0  0  0  0 0 0  0  0 0 0 0  0  0 0  0  0  0 29 2 2  2 2 30 0 0 29 2 2 30 0 0 0 29 2  2 2 2 2  2 2 2 2 2 2  2 2  2 2  2 2  2 2  2 2  2 2  2  2 2 2 2  2  2  2 2  30 0  0  0 0 0 0  0  0  0 0 0 0  0 0  0 0 0 0  0  0 0  0 0 0  0  0 0 29 2 2 2 2 2 30 0 0 0 0 0 0 0 0 0 






