20
14
0 0 0 0  0 0 0 0 0 0 0 0 0 0 0 0  0 0 0 0
0 0 0 0  0 0 0 0 0 0 0 0 0 0 0 0  0 0 0 0
0 0 0 0  0 0 0 0 0 0 0 0 0 0 0 0  0 0 0 0
0 0 0 0  0 0 0 0 0 0 0 0 0 0 0 0  0 0 0 0
0 0 0 0  0 0 0 0 0 0 0 0 0 0 0 0  0 0 0 0
0 0 0 0  0 0 0 0 0 0 0 0 0 0 0 0  0 0 0 0
0 0 0 0  0 0 0 0 0 0 0 0 0 0 0 0  0 0 0 0
0 0 0 0  0 0 0 0 0 0 0 0 0 0 0 0  0 0 0 0
0 0 0 0  0 0 0 0 0 0 0 0 0 0 0 0  0 0 0 0
0 0 0 0  0 0 0 0 0 0 0 0 0 0 0 0  0 0 0 0
0 0 0 0  0 0 0 0 0 0 0 0 0 0 0 0  0 0 0 0
0 0 0 0  0 0 0 0 0 0 0 0 0 0 0 0  0 0 0 0
0 0 0 22 1 1 1 1 1 1 1 1 1 1 1 23 0 0 0 0
0 0 0 29 2 2 2 2 2 2 2 2 2 2 2 30 0 0 0 0
0 0 0 29 2 2 2 2 2 2 2 2 2 2 2 30 0 0 0 0
